XXXXXXXXXX
X  XXXXXXX
X  XXXXXXX
X  X     X
X     X  X
XXXXXXX  X
XXXXXXX  X
XXXXXXXXOX
