XXXXXXXXXXXXXXXXXXXXXX
X  X   X    X     X  X
X  X X XXX  X XX  X  X
X    X   X    X   X XX
X  XXXXX X  XXXXXXX  X
X  X   X X    X     XX
X  X X XXXXXX    XX  X
X  X      X      X   X
X  XXXXXX X   XXXX XXX
X                 X  X
X  XXX  XXXXXXX  X X X
X  XXX           X X X
X  X X  XXXXXXXXXX X X
X  X X          X  X X
X    XXXXX X  X   XX X
XXXXXXXXX  X  XXXXXX X
X  X   X   X  X    X X
X    X    XX  X  X   X
X    X     X  X   X  X  
XXXXXXXXXXXXOXXXXXXXXX
