XXXXXXXXXXXXXXXXXXXXXXXXXXXXX
X  XXXXXXXX  XXXXXXX        O
X  XXXXXXXX  XXXXXXXXXXX  XXX
X  XXXXXXXX  XXXXXXXXXXX  XXX
X              XXXXXXXXX  XXX
XXXXX  XXXX  XXXXXXX      XXX
XXXXX  XXXX  XXXXXXX  XXXXXXX
XXXXX  XXXX  XXXXXXX  XXXXXXX
XXXXX  XXXX  XXXXXXX  XXXXXXX
XXXXX  XXXX  XXXXXXX  XXXXXXX
XXXXX        XXXXXXX  XXXXXXX
XXXXXXX  XXXXXXXX     XXXXXXX
X XXXXX  XXXXXXXX  XXXXXXXXXX
X XXXXX  XXXXXXXX  XXXXXXXXXX
X                  XXXXXXXXXX
XXXXXXXXXXXXXXXXXXXXXXXXXXXXX
XXXXXXXXXXXXXXXXXXXXXXXXXXXXX
